11111111111111111111111111111111111111111
100000000000000C00000C0010000000010010001
10100101001000001010010010000101010011001
10100100101010100010010011100101000001001
1P0000000C00C0000000000000100000C11111111
100000000000000C00000C0010000000010010001
10100101001000001010010010000101010011001
10100100101010100010010011100101000001001
100000000000000C00000C0010000000010010001
10100101001000001010010010000101010011001
10100100101010100010010011100101000001001
100000000000000C00000C0010000000010010001
10100101001000001010010010000101010011001
10100100101010100010010011100101000001001
100000000000000C00000C0010000000010010001
10100101001000001010010010000101010011001
10100100101010100010010011100101000001001
100000000000000C00000C0010000000010010001
10100101001000001010010010000101010011001
10100100101010100010010011100101000001001
100000000000000C00000C0010000000010010001
10100101001000001010010010000101010011001
10100100101010100010010011100101000001001
100000000000000C00000C0010000000010010001
10100101001000001010010010000101010011001
10100100101010100010010011100101000001001
100000000000000C00000C0010000000010010001
10100101001000001010010010000101010011001
10100100101010100010010011100101000001001
11111111111111111111111111111111111111111
