1111111111111
10E10C0000001
1000011111001
10P0100000001
1111111111111