11111111111111111111111111111111
10001111C101111000011110101111E1
10000000000101000000000000101001
10110101100000010110101100000011
10000101111100000000101111100001
10111100101001000111100101001001
10100011000011010100011000011011
10000111101C110000001111010110C1
10011111001111110011111001111111
10010000010000110010000010000111
10010100010001000010100010001001
10011001001001100011001001001101
10010010011C10000010010011010001
10100110000001000100110000001001
10101111001111100101111001111101
10000111100000000000111100000001
10001111010111100001111010111101
1000000000C101000000000000101001
10110101100000010110101100000011
10000101111100000000101111100001
10111100101001000111100101001001
1C100011000011010100011000011011
100001111010110000001111010110C1
10011111001111110011111001111111
10010000010000110010000010000111
10010100010001000010100010001001
10011001001001100011001001001101
10010010011010000010010011010001
10100110000001000100110000001001
10101111001111100101111001111101
1P000111100000000000111100C00001
11111111111111111111111111111111
