11111111111111111111111111111111111111111111111111111111111
1P000000000000000000000000000000000000000000000000000000001
10101010101010101010101010101010101010101010101010101010101
100C0C0C0C0C0C0C0C0C0C0C0C0C0C0C0C0C0C0C0C0C0C0C0C0C0C0C001
10101010101010101010101010101010101010101010101010101010101
100C0C0C0C0C0C0C0C0C0C0C0C0C0C0C0C0C0C0C0C0C0C0C0C0C0C0C001
10101010101010101010101010101010101010101010101010101010101
100C0C0C0C0C0C0C0C0C0C0C0C0C0C0C0C0C0C0C0C0C0C0C0C0C0C0C001
10101010101010101010101010101010101010101010101010101010101
100C0C0C0C0C0C0C0C0C0C0C0C0C0C0C0C0C0C0C0C0C0C0C0C0C0C0C001
10101010101010101010101010101010101010101010101010101010101
100C0C0C0C0C0C0C0C0C0C0C0C0C0C0C0C0C0C0C0C0C0C0C0C0C0C0C001
10101010101010101010101010101010101010101010101010101010101
100C0C0C0C0C0C0C0C0C0C0C0C0C0C0C0C0C0C0C0C0C0C0C0C0C0C0C001
10101010101010101010101010101010101010101010101010101010101
100C0C0C0C0C0C0C0C0C0C0C0C0C0C0C0C0C0C0C0C0C0C0C0C0C0C0C001
10101010101010101010101010101010101010101010101010101010101
100C0C0C0C0C0C0C0C0C0C0C0C0C0C0C0C0C0C0C0C0C0C0C0C0C0C0C001
10101010101010101010101010101010101010101010101010101010101
100C0C0C0C0C0C0C0C0C0C0C0C0C0C0C0C0C0C0C0C0C0C0C0C0C0C0C001
10101010101010101010101010101010101010101010101010101010101
100C0C0C0C0C0C0C0C0C0C0C0C0C0C0C0C0C0C0C0C0C0C0C0C0C0C0C001
10101010101010101010101010101010101010101010101010101010101
100C0C0C0C0C0C0C0C0C0C0C0C0C0C0C0C0C0C0C0C0C0C0C0C0C0C0C001
10101010101010101010101010101010101010101010101010101010101
100C0C0C0C0C0C0C0C0C0C0C0C0C0C0C0C0C0C0C0C0C0C0C0C0C0C0C001
10101010101010101010101010101010101010101010101010101010101
100C0C0C0C0C0C0C0C0C0C0C0C0C0C0C0C0C0C0C0C0C0C0C0C0C0C0C001
10101010101010101010101010101010101010101010101010101010101
100C0C0C0C0C0C0C0C0C0C0C0C0C0C0C0C0C0C0C0C0C0C0C0C0C0C0C001
10101010101010101010101010101010101010101010101010101010101
100000000000000000000000000000000000000000000000000000000E1
11111111111111111111111111111111111111111111111111111111111
