1111111111111
100100C000001
1000011111001
100P10E000001
1111111111111