1111111111111
100100C000001
1000011111001
100P1CE000001
1111111111111